6
022222222200
020000002200
022020002222
220000000022
200220000122
200000000122
222200222122
000222222222
033333333300
030000003300
033032003333
330002000033
300330000033
300002000033
333310333033
000333333333
------------
022222222200
200001212200
200022202200
200000000200
200020200200
200000000200
202000000200
022222222200
033333333300
300000303300
300033303300
300000200300
300030300300
300002000300
313000000300
033333333300
------------
000000002222
000222222012
000200000002
000200000002
000200000002
222200222202
201000000002
222222222222
000000003333
000333333003
000300000003
000300000003
000301000003
333302333323
300000000003
333333333333
------------
222222222222
210002022022
210002220002
210000000002
210000000002
210002222002
200000000002
222222222222
333333333333
300003033133
300003330003
300000002203
300000000203
302003333203
300000000003
333333333333
------------
002222222000
002100012000
002020202000
002000002000
002020002000
002100012000
002222222000
000000000000
003333333000
003000003000
003032303000
003021203000
003032003000
003000003000
003333333000
000000000000
------------
002222000000
002002200000
222001222000
200000002220
200001200020
222210120020
000220100020
000022222220
003333000000
003003300000
333010333000
300202003330
300220300030
333300032030
000330000030
000033333330
------------